12 5
*,, *,, *,, *,, *,, *,, *,, *,, *,, *,, *,, *,,
*,, ___ ___ ___ #,, ___ #,, ___ ___ ___ *,, *,,
*,, @,, ___ #,, ___ #,, ___ #,, ___ ___ *,, *,,
*,, ___ ___ ___ #,, ___ #,, ___ ___ ___ G,, *,,
*,, *,, *,, *,, *,, *,, *,, *,, *,, *,, *,, *,,