9 10
*,, *,, *,, *,, *,, *,, *,, *,, *,,
*,, G,, ___ ___ ___ ___ ___ ___ *,,
*,, D2, ___ ___ ___ ___ |,, ___ *,,
*,, K2, ___ ___ ___ -,, ___ -,, *,,
*,, ___ ___ ___ ___ ___ ___ ___ *,,
*,, ___ ___ ___ $,, ___ ___ K3, *,,
*,, ___ o,, ___ $,, ___ ___ D3, *,,
*,, K1, o,, ___ ___ ___ ___ ___ *,,
*,, D1, ___ ___ ___ ___ ___ @,, *,,
*,, *,, *,, *,, *,, *,, *,, *,, *,,