9 10
*,, *,, *,, *,, *,, *,, *,, *,, *,,
*,, G,, ___ ___ ___ ___ ___ ___ *,,
*,, ___ ___ ___ ___ ___ |,, ___ *,,
*,, ___ ___ ___ ___ -,, ___ -,, *,,
*,, ___ ___ ___ ___ ___ ___ ___ *,,
*,, ___ ___ ___ $,, ___ ___ ___ *,,
*,, ___ ___ ___ $,, ___ ___ ___ *,,
*,, ___ o,, ___ ___ ___ ___ ___ *,,
*,, ___ ___ ___ ___ ___ ___ @,, *,,
*,, *,, *,, *,, *,, *,, *,, *,, *,,